R 1000 800
       NO     pics/homecoming.xpm
     SO       pics/eagle.xpm

                                  WE                                       pics/mossy.xpm


EA        pics/wood.xpm
              S             ./path_to_the_sprite_texture






   1111    11111
111100111111000011111
10000010000001111
100E0000000000001
110000000000000001
111111111111111111
