R 600 500
       NO     pics/homecoming.xpm
     SO       pics/eagle.xpm

                                  WE                                       pics/mossy.xpm


EA        pics/wood.xpm
              S             pics/barrel.xpm






   11111   111111
1111020111110220011111
1000000000000000211111
120000S0000000000111111
1000000000000000211
1000000000000000021
10020000000020000001
11111111111111111111111


