R 1080 700
       NO     pics/haunted.xpm
     SO       pics/forest.xpm

                                  WE                                       pics/mossy.xpm


EA        pics/wood.xpm
              S             pics/beyonce.xpm






11111111111111111111111
10000000020000000000001
100000000N00000000000111
1000000000000012011111
1222200000000000021
1211000000000011111111
1222200011111000000021
1111111110000000011111111111
       1000000000111
	   1111111111111
