R 1000 800
       NO     pics/homecoming.xpm
     SO       pics/eagle.xpm

                                  WE                                       pics/mossy.xpm


EA        pics/wood.xpm
              S             ./path_to_the_sprite_texture






   1111    11111
111100111111000011111
100000100000011111
10000000S000000011
110000000000000001
11111000000000011111111111
11110000000000000111111
1111001111100000000000111111111
10000010000001111111000001
10000000000000001000000001
11000000000000000100000001
11111111111111111111110001
                    1111111


