R 1900 1080


       NO     pics/night_city.xpm



     SO       pics/matelas.xpm



                                  WE                                       pics/purplestone.xpm



EA        pics/wood.xpm



              S             pics/miles-davis.xpm


              
F ,,,,,,,,,,,,,,89,,,,,,0,0
C 21, 12, 12








11111111111111111
1000000000000N0111001
100000000000001111111111111111
100000222000011
1111111111111111
            1000001111
            1000111
            1111111111


