R 600 400
       NO     ./path_to_the_north_texture
     SO          ./path_to_the_south_texture
WE         ./path_to_the_west_texture
EA        ./path_to_the_east_texture
              S             ./path_to_the_sprite_texture




1111111110000000
1000000110000000
1000N001100000000000000
11000000100000000000000
11111111000000000000000000000
0000000000000000000000000000
00000000000000000000000000000000000
000000000000000000000000000000000000000000
00000000000000000000000000000000000
