R 600 400
       NO     ./path_to_the_north_texture
     SO          ./path_to_the_south_texture
WE         ./path_to_the_west_texture
EA        ./path_to_the_east_texture
              S             ./path_to_the_sprite_texture




11111111
1000N001
10000001
11000001
11111111
