R 600 500
       NO     pics/homecoming.xpm
     SO       pics/forest.xpm

                                  WE                                       pics/mossy.xpm


EA        pics/wood.xpm
              S             pics/greenlight.xpm






111111111111111
100000000200001
100000000N0000111
1000000000000012011
1222200000000000021
1211000000000011111
1222200000000000021
111111111111111111111
