R 600 500


       NO     pics/night_city.xpm



     SO       pics/matelas.xpm



                                  WE                                       pics/purplestone.xpm



EA        pics/wood.xpm



              S             pics/miles-davis.xpm



F ,,,,,,,,,,,,,,89,,,,,,0,0
C 21, 12, 12








11111111111111111
1000000000000N011
10000000000000111
11111111111111111

