R	900		600

NO 			pics/matelas.xpm
SO       pics/matelas.xpm
WE  pics/matelas.xpm
EA     pics/wood.xpm

S  pics/miles-davis.xpm


F 0,,254,0
C 255, 0, 0,

1111111 00000 	1111111 00000 	
1000001111111000011111111
100000N0000011111111
100000002220000011111111
11100000111111111111111
1000001111111000000	 
1000000000011111111
100000002220000011111111
110000000111111111111111111
110000000000001
10000011111111100	 
100000000001111111111111111
10000000222000011111
111111100000011111111111111111111
1111100000011111111111111111111
111100000000000011111111111111
11111000000000001111111111111
1111110000011111111111111111
10000000111111111111111111
110000000000001
10000011111111100	 
100000000001111111111111111
10000000222000011111
111111100000011111111111111111111
1111100000011111111111111111111
111100000000000011111111111111
11111000000000001111111111111
1111111111111111111111111111




















































