R	600		500

NO 			pics/matelas.xpm
SO       pics/matelas.xpm
WE  pics/matelas.xpm
EA     pics/wood.xpm

S  pics/beyonce.xpm


F 0,,254,0
C 255, 0, 0,

1111111100000111111111111111111111
100000111111100000000000000000001111111
100000E00000000000000000000000001111111
100000000000000000000000000000011111111
11100000000000000000000000000000111111111
11000000000000000000011111111111
100000111111100001111111
1000000000000000001111111
100000002220000011111111
11100000000000000011111111111
1110000000011111111111
100000111111100000000111
1000000000000000000001111
10000000222000000000011111111
1110000000000000000000000000111111111
11111111000000000111111111111
1000000000000000000001111111
1000000000000000000001111111
100000002220000011111111
111100000000000000011111111
11100000000000000011111111111
100000022222220000000001111111
10000000000000000001111111
100000002220000011111111
111111111111111111111111



















































