R 1080 700
       NO     pics/night_city.xpm
     SO       pics/matelas.xpm

                                  WE                                       pics/purplestone.xpm


EA        pics/wood.xpm
              S             pics/miles-davis.xpm

F 80,0,       0
C 0, 0,   125

11111111111111111111111
10000000020000000000001
1000000000000000000111
1000011111111111111111
1000N0011111111111
1222200000000000021
11111111111111111111111
