R 1000 500
       NO     ./path_to_the_north_texture
     SO          ./path_to_the_south_texture
WE         ./path_to_the_west_texture
EA        ./path_to_the_east_texture
              S             ./path_to_the_sprite_texture


111111111111111111111111
1N0000000000000000000011
100000000000000000000011
1111111111111000000000011
          111111111000001
          100000000000001
          111111111111111