R 1080 700
       NO     pics/greystone.xpm
     SO       pics/forest.xpm

                                  WE                                       pics/purplestone.xpm


EA        pics/wood.xpm
              S             pics/miles-davis.xpm

F 015,016,017
C 001, 002,003

11111111111111111111111
10000000020000000000001
100000000N0000000000111
100000000000012011111
1222200000000000021
1111111111111111111
