R	600		500

NO 			pics/matelas.xpm
SO       pics/matelas.xpm
WE  pics/matelas.xpm
EA     pics/wood.xpm

S  pics/miles-davis.xpm


F 0,,254,0
C 255, 0, 0,

11111111111111111
100000N000001111111
100000002220000011111111
1111111111111111111111

