R 1900 1080
       NO     pics/night_city.xpm
     SO       pics/matelas.xpm

                                  WE                                       pics/purplestone.xpm


EA        pics/wood.xpm
              S             pics/miles-davis.xpm

F 80,0,0


C 0,255,255




111	
1N111001
1111000111111111111
111111111
