111111111
100101002
102001002
1100N1002
111111111
1001
111111111
