R	640 


       NO     pics/night_city.xpm



     SO       pics/matelas.xpm



                                  WE                                       pics/purplestone.xpm



EA        pics/wood.xpm



              S             pics/miles-davis.xpm



F ,,,,,,,,,,,,,,89,,,,,,0,0
C 255, 1, 2,








11111111111111111
100N000000000011
1000000000000011111111
1111111111111111111111

