R 1080 700
       NO     pics/night_city.xpm
     SO       pics/matelas.xpm

                                  WE                                       pics/purplestone.xpm


EA        pics/wood.xpm
              S             pics/miles-davis.xpm

F 80,0,       0
C 0, 0,   125

11111111
10000011
10000011111111
10000000000001
10000N000000001
111111111111111