R 1900 1080
       NO     pics/homecoming.xpm
     SO       pics/eagle.xpm

                                  WE                                       pics/mossy.xpm


EA        pics/wood.xpm
              S             ./path_to_the_sprite_texture






   1111    11111
111100111111000011111
120000100000011111
12200000S00002222111111
11000000002222220000001
11111111111111111111111


