R	1900		1080

NO 			pics/matelas.xpm
SO       pics/matelas.xpm
WE  pics/matelas.xpm
EA     pics/wood.xpm

S  pics/miles-davis.xpm


F 0,,254,0
C 255, 0, 0,

1111111 00000 	1111111 00000 	
1000001111111000000	 
100000N0000011111111
100000002220000011111111
1111111111111111111111
1000001111111000000	 
1000000000011111111
100000002220000011111111
1111111111111111111111
1111111 00000 	
1000001111111000000	 
1000000000011111111
100000002220000011111111
1111111111111111111111

