111111111
100000001
111000001
111100N01
111111111
