R	640	480
     NO     pics/night_city.xpm



     SO       pics/matelas.xpm



                                  WE                                       pics/purplestone.xpm



EA        pics/wood.xpm



              S             pics/miles-davis.xpm

F 255,0,255


C 0,128,128

1111111111111111111111111111111111111111111
1000000000000000000000000000000002000W02001
1000111111111111111111111111111111110000111
1000111111111111111111111111111111110000111
1000000000000000000000000000000000000000111
10000000000000000h0000000000000000000000111
1111111111111111111111111111111111111111111

