R	1200	800
NO	pics/kl.xpm
SO	pics/wood.xpm
WE	pics/kl.xpm
EA	pics/wood.xpm
S	pics/brogniart.xpm
F 180,200,200
C 10,10,19

1111111111111111111111111111
11000000000011000000000011
11000E00000011000000000011
110000000000000000000000111111111
110022200000000000000000000000001
1100222000000000000222000000000001
110011100000000000000000000000011111
110011100000000000001110000000000011
1111111111111111111111111111111111111
