R	1200	800
NO	pics/drapeau_commune.xpm
SO	pics/incendiehoteldeville.xpm
WE	pics/vendome.xpm
EA	pics/wood.xpm
S	pics/louise-michel.xpm
F 180,200,200
C 10,10,19

1111111111111111111
1100000000001100011
11000S0000001100011
1100000000000000011
1100222000000000001
1100222000000000001
1100111000000000001
1111111111111111111
