R	-640	480
 NO pics/night_city.xpm
     SO       pics/matelas.xpm
     WE                                       pics/purplestone.xpm
EA        pics/wood.xpm
S             pics/miles-davis.xpm

F 255,0,255
C 0,128,128


1111111111111111111111111111111111111111111
1000000000000000000000000000000002000002001
10000000000000000000000000000000000020000W1
1000111111111111111111111111111111111111111
1000100000000001000000000111111111110000111
1000100000000001000000000111111111110000111
1000100000000001000000000000001111110000111
1000100000000001000000000000000001110000111
1000100000000001000000000000000000000000111
1000100000000000000000000000000000000000111
1000111111111111111111111111111111110000111
1000111111111111111111111111111111110000111
1000000000000000000000000000000000000000111
1000000000000000000000000000000000000000111
1111111111111111111111111111111111111111111
